0 0 0 0 0 0 0 0 0 0 0 0 0 0 0 0 0 0 0 0 0 0 0 0 0 0 0 0 0 0 0 0 0 0 0 0 0 0 0 0 0 0 0 0 0 0 0 0 0 0 
0 0 0 0 0 0 0 0 0 0 0 0 0 0 0 0 0 0 0 0 0 0 0 0 0 0 0 0 0 0 0 0 0 0 0 0 0 0 0 0 0 0 0 0 0 0 0 0 0 0 
0 0 0 0 5 4 4 4 4 4 4 4 4 4 5 4 4 4 4 4 4 4 4 4 4 0 0 0 0 1 1 1 1 1 1 1 1 1 1 1 1 1 1 1 1 1 0 0 0 0 
0 0 4 4 4 4 6 6 6 6 6 6 6 6 6 6 6 4 4 4 4 4 5 4 4 0 0 0 0 1 1 1 1 1 1 1 1 1 1 1 1 1 1 1 1 1 1 0 0 0 
0 0 4 4 4 4 6 3 3 3 3 3 3 3 3 3 6 4 4 4 4 4 4 4 4 0 0 0 0 1 1 1 1 1 1 1 1 2 1 1 2 2 1 1 1 1 1 1 0 0 
0 0 4 4 5 4 6 3 2 2 2 2 2 2 2 3 6 4 4 4 5 4 4 4 4 0 0 0 0 0 1 1 1 1 1 1 1 1 2 1 1 1 1 1 2 1 1 1 0 0 
0 0 6 4 4 4 6 3 2 2 2 2 2 2 2 3 6 4 4 4 4 4 4 4 4 0 0 0 0 0 1 1 1 1 1 1 2 1 1 2 2 2 1 1 1 1 1 1 0 0 
0 0 6 6 4 4 6 3 2 2 2 2 2 2 2 3 6 4 4 4 4 4 4 4 4 4 0 0 0 0 1 1 1 1 1 1 1 1 1 1 1 2 1 1 1 1 1 0 0 0 
0 0 6 6 4 4 6 3 2 2 2 2 2 2 2 3 6 4 4 4 4 4 4 4 4 5 0 0 0 0 1 1 1 1 1 1 1 2 1 2 1 1 1 1 1 1 0 0 0 0 
0 0 6 6 4 4 6 3 2 2 2 2 2 2 2 3 6 4 5 5 4 5 4 4 4 4 0 0 0 0 0 1 1 1 1 2 2 2 1 1 1 1 1 1 0 0 0 0 0 0 
0 0 6 4 4 4 6 3 2 2 2 2 2 2 2 3 6 4 4 4 4 4 4 4 4 4 0 0 0 0 0 1 1 1 2 2 2 1 1 1 1 1 1 1 0 0 0 0 0 0 
0 0 4 4 5 4 6 3 3 3 2 2 2 3 3 3 6 4 4 5 4 4 4 4 5 4 4 0 0 0 0 1 1 2 2 2 1 1 1 1 1 0 0 0 0 0 0 0 0 0 
0 0 4 4 5 5 6 6 6 6 2 2 2 6 6 6 6 5 5 5 4 5 5 4 4 5 5 0 0 0 0 0 2 2 2 1 1 1 1 1 1 0 0 0 0 0 0 0 0 0 
0 0 4 4 4 4 5 5 5 5 2 2 2 5 5 5 5 5 5 5 5 5 5 5 5 5 5 2 0 0 0 2 2 2 1 1 1 1 1 1 0 0 0 0 0 0 0 0 0 0 
0 0 4 5 4 4 4 5 5 5 2 2 2 2 2 2 2 2 2 2 2 2 2 2 2 2 2 2 0 0 2 2 2 0 1 1 1 0 0 0 0 0 0 0 1 1 1 1 0 0 
0 0 4 4 4 4 4 4 5 5 2 2 2 2 2 2 2 2 2 2 2 2 2 2 2 2 2 2 2 2 2 2 0 0 0 0 0 0 0 0 0 0 0 1 1 1 1 1 0 0 
0 0 4 4 4 4 4 5 5 5 2 2 2 2 2 2 2 2 2 2 2 2 2 2 2 2 2 2 2 2 2 0 0 0 0 0 0 0 0 0 0 0 1 1 1 1 1 1 0 0 
0 0 4 5 4 4 5 5 5 5 2 2 2 2 2 2 2 2 2 2 2 2 2 2 2 2 2 2 2 2 2 0 0 0 0 0 0 0 0 0 1 1 1 1 1 1 1 1 0 0 
0 0 4 4 4 4 4 4 5 5 2 2 2 5 5 5 5 5 5 5 5 5 5 5 5 5 5 2 2 2 2 2 0 0 0 0 0 1 1 1 1 1 1 1 1 1 1 1 0 0 
0 0 5 4 4 4 6 6 6 6 2 2 2 6 6 6 6 5 5 5 4 5 5 4 5 5 5 3 2 2 2 2 3 1 1 1 1 1 1 1 1 1 1 1 1 1 1 1 0 0 
0 0 4 4 4 5 6 3 3 3 2 2 2 3 3 3 6 4 5 5 5 4 4 4 5 5 4 3 2 2 2 2 3 1 1 1 1 1 1 1 1 1 1 1 1 1 1 1 0 0 
0 0 4 4 4 4 6 3 2 2 2 2 2 2 2 3 6 4 5 4 4 0 0 0 4 4 5 3 2 2 2 2 3 1 1 1 1 1 1 1 1 1 1 1 1 1 1 1 0 0 
0 0 4 5 4 4 6 3 2 2 2 2 2 2 2 3 6 5 4 0 0 0 0 0 4 5 4 3 2 2 2 2 3 1 1 1 1 1 1 1 1 1 1 1 1 1 1 1 0 0 
0 0 4 4 4 5 6 3 2 2 2 2 2 2 2 3 6 4 5 4 0 0 0 0 4 4 4 3 2 2 2 2 3 1 1 1 1 1 1 1 1 1 1 1 1 1 1 1 0 0 
0 0 4 4 4 5 6 3 2 2 2 2 2 2 2 3 6 4 4 4 0 0 0 0 0 4 5 3 2 2 2 2 3 1 1 1 1 1 1 1 1 1 1 1 1 1 1 1 0 0 
0 0 4 4 4 4 6 3 2 2 2 2 2 2 2 3 6 4 5 6 6 0 0 0 0 0 4 3 2 2 2 2 3 1 1 1 1 1 1 1 1 1 1 1 1 1 1 1 0 0 
0 0 4 4 4 4 6 3 2 2 2 2 2 2 2 3 6 4 4 6 6 0 0 0 0 0 4 3 2 2 2 2 3 1 1 1 1 1 1 1 1 1 1 1 1 1 1 1 0 0 
0 0 4 4 4 4 6 3 3 3 3 3 3 3 3 3 6 4 4 4 6 6 0 0 0 6 6 3 2 2 2 2 3 1 1 1 1 1 1 1 1 1 1 1 1 1 1 1 0 0 
0 0 4 4 5 4 6 6 6 6 6 6 6 6 6 6 6 4 5 4 6 6 6 6 6 6 6 3 2 2 2 2 3 1 1 1 1 1 1 1 1 1 1 1 1 1 1 1 0 0 
0 0 4 4 4 4 6 6 6 4 4 4 4 4 4 5 6 4 4 4 4 6 6 6 6 3 3 3 1 1 1 1 3 3 3 1 1 1 1 1 1 1 1 1 1 1 1 1 0 0 
0 0 4 4 4 5 4 6 6 6 5 4 4 4 4 4 1 4 4 4 4 4 6 6 3 3 1 1 1 1 1 1 1 1 3 3 1 1 1 1 1 1 1 1 1 1 1 1 0 0 
0 0 4 4 4 4 4 6 6 6 4 4 4 4 1 1 1 4 5 4 4 4 4 6 3 1 1 1 1 1 1 1 1 1 1 3 1 1 1 1 1 1 1 1 1 1 1 1 0 0 
0 0 4 4 4 4 4 1 1 1 1 1 1 1 1 1 1 4 4 4 4 5 4 3 3 1 1 1 1 1 1 1 1 1 1 3 3 1 1 1 1 1 1 1 1 1 1 1 0 0 
0 0 1 1 1 1 1 1 1 1 1 1 1 1 1 1 1 3 3 3 3 3 3 3 1 1 1 1 1 1 1 1 1 1 1 1 3 3 3 3 3 3 1 1 1 1 1 1 0 0 
0 0 1 1 1 1 1 1 1 1 1 1 1 1 1 1 1 3 2 2 2 2 2 3 1 1 1 1 3 3 3 3 1 1 1 1 3 2 2 2 2 3 1 1 1 1 1 1 0 0 
0 0 1 1 1 1 1 1 1 1 1 1 1 1 1 1 1 6 2 2 2 2 2 1 1 1 1 1 3 0 0 3 1 1 1 1 1 2 2 2 2 6 1 1 1 1 1 1 0 0 
0 0 1 1 1 1 1 1 1 1 1 1 1 1 1 1 1 6 2 2 2 2 2 1 1 1 1 1 3 0 0 3 1 1 1 1 1 2 2 2 2 6 1 1 1 1 1 1 0 0 
0 0 1 1 1 1 1 1 1 1 1 1 1 1 1 1 1 3 2 2 2 2 2 3 1 1 1 1 3 3 3 3 1 1 1 1 3 2 2 2 2 3 1 1 1 1 1 1 0 0 
0 0 1 1 1 1 1 1 1 1 1 1 1 1 1 1 1 3 3 3 3 3 3 3 1 1 1 1 1 1 1 1 1 1 1 1 3 3 3 3 3 3 1 1 1 1 1 1 0 0 
0 0 1 1 1 1 1 1 1 1 1 1 1 1 1 1 1 1 1 1 1 1 1 3 3 1 1 1 1 1 1 1 1 1 1 3 3 1 1 1 1 1 1 1 1 1 1 1 0 0 
0 0 1 1 1 1 1 1 1 1 1 1 1 1 1 1 1 1 1 1 1 1 1 1 3 1 1 1 1 1 1 1 1 1 1 3 1 1 1 1 1 1 1 1 1 1 1 1 0 0 
0 0 1 1 1 1 1 1 1 1 1 1 1 1 1 1 1 1 1 1 1 1 1 1 3 3 1 1 1 1 1 1 1 1 3 3 1 1 1 1 1 1 1 1 1 1 1 1 0 0 
0 0 1 1 1 1 1 1 1 1 1 1 1 1 1 1 1 1 1 1 1 1 1 1 1 3 3 3 1 1 1 1 3 3 3 1 1 1 1 1 1 1 1 1 1 1 1 1 0 0 
0 0 1 1 1 1 1 1 1 1 1 1 1 1 1 1 1 1 1 1 1 1 1 1 1 1 1 3 1 1 1 1 3 1 1 1 1 1 1 1 1 1 1 1 1 1 1 1 0 0 
0 0 1 1 1 1 1 1 1 1 1 1 1 1 1 1 1 1 1 1 1 1 1 1 1 1 1 3 6 6 6 6 3 1 6 6 6 1 1 1 1 1 1 1 1 1 1 1 0 0 
0 0 1 1 1 1 1 1 1 1 1 1 1 1 1 1 1 1 1 1 1 1 1 1 1 6 6 6 6 6 6 6 6 6 6 6 6 1 1 1 1 1 1 1 1 1 1 1 0 0 
0 0 0 1 1 1 1 1 1 1 1 1 1 1 1 1 1 1 1 1 1 1 1 6 6 6 6 6 6 6 6 6 6 6 6 6 6 1 1 1 1 1 1 1 1 1 1 0 0 0 
0 0 0 0 1 1 1 1 1 1 1 1 1 1 1 1 1 1 1 1 1 1 1 1 6 6 6 6 6 6 6 6 6 6 1 1 1 1 1 1 1 1 1 1 1 1 0 0 0 0 
0 0 0 0 0 0 0 0 0 0 0 0 0 0 0 0 0 0 0 0 0 0 0 0 0 0 0 0 0 0 0 0 0 0 0 0 0 0 0 0 0 0 0 0 0 0 0 0 0 0 
0 0 0 0 0 0 0 0 0 0 0 0 0 0 0 0 0 0 0 0 0 0 0 0 0 0 0 0 0 0 0 0 0 0 0 0 0 0 0 0 0 0 0 0 0 0 0 0 0 0 
